Jalan Hasanuddin => Jalan Hasanuddin
Jalan Uluwatu => Jalan Uluwatu
Sutoyo => Jalan Sutoyo
Jalan Raya Sesetan => Jalan Raya Sesetan
Jl. Bougenville Boulevard => Jalan Bougenville Boulevard
Jalan Ahmad Yani => Jalan Ahmad Yani
Jalan Uluwatu 2 => Jalan Uluwatu 2
Jl Surgiwa => Jalan L Surgiwa
Jl. Buni Sari => Jalan Buni Sari
Jalan Hassanudin => Jalan Hassanudin
Puputan 1 => Jalan Puputan 1
jalan Seroja => Jalan Seroja
Tukad Gangga 1 => Jalan Tukad Gangga 1
Jalan Pantai Batu Bolong 60 => Jalan Pantai Batu Bolong 60
Jalan Lanyahan, Br Nagi => Jalan Lanyahan
Jalan Diponegoro => Jalan Diponegoro
Sunset Road => Sunset Road
Angsoka => Jalan Angsoka
Jalan H.O.S. Cokroaminoto => Jalan H.O.S. Cokroaminoto
Jalan Wahidin => Jalan Wahidin
Taman Kanak-Kanak Kartika => Jalan Taman Kanak
Bali Nusa Dua Tourism Complex, Lot N5 => Jalan Bali Nusa Dua Tourism Complex
Jalan Mawar => Jalan Mawar
Jalan Hayam Wuruk => Jalan Hayam Wuruk
Jalan Pulau Kawe => Jalan Pulau Kawe
Pangkung Sari Street => Pangkung Sari Street
jln flamboyan2 perumnas => Jalan Flamboyan2 Perumnas
Jalan Karang Mas Sejahtera => Jalan Karang Mas Sejahtera
Gadung => Jalan Gadung
Belitung => Jalan Belitung
Jl. Tanjung Raya B.B.Agung Negara => Jalan Tanjung Raya B.B.Agung Negara
Dr. Kusuma Atmaja => Jalan Dr. Kusuma Atmaja
Slamet Riyadi 1 => Jalan Slamet Riyadi 1
P.B. Sudirman => Jalan P.B. Sudirman
Jalan Padma => Jalan Padma
Jalan Kajeng 24 => Jalan Kajeng 24
Jl. Lingkar Timur Udayana => Jalan Lingkar Timur Udayana
Jl. Sri Kresna => Jalan Sri Kresna
MT Haryono => Jalan MT Haryono
Jalan Hotel Puri Bagus => Jalan Hotel Puri Bagus
Puputan 2 => Jalan Puputan 2
Jl. Bukit Permai => Jalan Bukit Permai
Raya Sanggingan => Jalan Raya Sanggingan
Jalan Raya Amed, Desa Bunutan => Jalan Raya Amed
Jalan Jeda => Jalan Jeda
D.I. Panjaitan => Jalan D.I. Panjaitan
Jalan Gelogor Carik => Jalan Gelogor Carik
Jalan Muding Permai => Jalan Muding Permai
tegalsari 37 pantai berawa ,Canggu => Jalan Tegalsari 37 Pantai Berawa
Tukad Unda => Jalan Tukad Unda
Blue Ocean Boulevard => Jalan Blue Ocean Boulevard
Jalan Raya Seminyak, Gang Taman Sari => Jalan Raya Seminyak
Jl. Jepun => Jalan Jepun
Jalan Merdeka => Jalan Merdeka
Kapten Tantular => Jalan Kapten Tantular
Jalan Kenyeri => Jalan Kenyeri
Kalimantan => Jalan Kalimantan
Jl. Padma Utara => Jalan Padma Utara
Jl. Kampus Unud => Jalan Kampus Unud
Melati => Jalan Melati
Gunung Penulisan => Jalan Gunung Penulisan
Jalan Tukad Badung XXV => Jalan Tukad Badung XXV
JL Petitenget => Jalan L Petitenget
14 x tangkuban perahu => Jalan 14 X Tangkuban Perahu
Jalan Gootama => Jalan Gootama
Juwuk Manis => Jalan Uwuk Manis
Jalan Bypass Ngurah Rai => Jalan Bypass Ngurah Rai
Jalan Waturenggong => Jalan Waturenggong
Ubud Main Street => Ubud Main Street
Srikandi => Jalan Srikandi
Jalan Camplung Tanduk => Jalan Camplung Tanduk
Popies II / Benesari, Kuta => Jalan Popies II
Jalan Astina Selatan, Gianyar => Jalan Astina Selatan
Jalan Padma Timur => Jalan Padma Timur
Jalan Nenas Subagan => Jalan Nenas Subagan
Gang Merta Sedana => Jalan Gang Merta Sedana
Jl. Raya Amlapura-Singaraja => Jalan Raya Amlapura
Jalan Bypass Gatot Subroto => Jalan Bypass Gatot Subroto
Danau Tamblingan => Jalan Danau Tamblingan
Jalan Pura Mertasari => Jalan Pura Mertasari
Jalan Pulau Tarakan => Jalan Pulau Tarakan
Jalan Batu Mejan 8 => Jalan Batu Mejan 8
Cut Nyak Dhien => Jalan Cut Nyak Dhien
Tukad Gangga => Jalan Tukad Gangga
Lane Mandia => Jalan Lane Mandia
Jalan Segara => Jalan Segara
Jl.Bhineka Jati No.XI  => Jalan Bhineka Jati No.XI
Jalan Raya Desa => Jalan Raya Desa
Jalan Gatot Subroto => Jalan Gatot Subroto
By Pass Sunset Road => By Pass Sunset Road
Hanoman Road => Hanoman Road
Danau Poso => Jalan Danau Poso
Jalan Hanoman => Jalan Hanoman
Jalan Noja => Jalan Noja
Jalan Teratai => Jalan Teratai
Monkey Forest Road => Monkey Forest Road
wirayudha => Jalan Wirayudha
Yos Sudarso => Jalan Yos Sudarso
Jalan Ngurah Rai => Jalan Ngurah Rai
Tukad Musi => Jalan Tukad Musi
Jalan Sedap Malam => Jalan Sedap Malam
Jalan Double Six => Jalan Double Six
Jalan Asta Sura => Jalan Asta Sura
Jalan Surya Bhuana => Jalan Surya Bhuana
By Pass Ngurah Rai => Jalan By Pass Ngurah Rai
Jl.Dewi Sartika Gang Nusa Indah => Jalan Dewi Sartika Gang Nusa Indah
Jalan Raya Penestanan Kelod => Jalan Raya Penestanan Kelod
Jalan Kesari => Jalan Kesari
Jalan Legian => Jalan Legian
Gang Taman IV => Jalan Gang Taman IV
Jl. Gunung Agung No. 206 => Jalan Gunung Agung No. 206
Jalan Pantai Kedonganan => Jalan Pantai Kedonganan
Jalan Thamrin => Jalan Thamrin
Jalan Serma Kawi => Jalan Serma Kawi
Gg. Satria => Jalan Gg. Satria
Jalan Padma Utara => Jalan Padma Utara
jl. Raya Amlapura-Singaraja => Jalan Raya Amlapura
jalan pantai saba => Jalan Pantai Saba
Pulau Serangan => Jalan Pulau Serangan
Jl. Pasraman Unud => Jalan Pasraman Unud
Jalan Kartika Plaza => Jalan Kartika Plaza
Pemuda 2 => Jalan Pemuda 2
Jl. Bedugul => Jalan Bedugul
Ubud main street => Ubud Main Street
Monkey Forest Street => Monkey Forest Street
Jalan Wanagiri => Jalan Wanagiri
Jalan Pattimura => Jalan Pattimura
Jalan Pantai Batu Bolong => Jalan Pantai Batu Bolong
Jl. Parigata => Jalan Parigata
P.B. Sudirman Timur => Jalan P.B. Sudirman Timur
Jalan Komodo => Jalan Komodo
Hasanudin => Jalan Hasanudin
Pulau Timor => Jalan Pulau Timor
Cok Agung Tresna => Jalan Cok Agung Tresna
Jukut Paku, Singakerta, Ubud => Jalan Ukut Paku
Sugianyar => Jalan Sugianyar
Letda Tantular => Jalan Letda Tantular
Kapten Tantular 1 => Jalan Kapten Tantular 1
Jl. Raya Pengosekan => Jalan Raya Pengosekan
Jl. Bedugul, Sidakarya - Denpasar, Bali - Indonesia => Jalan Bedugul
Jl. Drupadi, No. 09, Seminyak => Jalan Drupadi
Jalan Bisma => Jalan Bisma
Jalan Serma Made Pil => Jalan Serma Made Pil
Jl. Abangan => Jalan Abangan
Jalan Nangka => Jalan Nangka
Jalan Lebak Bene Sari Poppies => Jalan Lebak Bene Sari Poppies
Jalan Caplak Tanduk => Jalan Caplak Tanduk
Jalan Bukit Catu => Jalan Bukit Catu
Kepundung => Jalan Kepundung
Jalan Gunung kawi => Jalan Gunung Kawi
Jalan Monkey Forest => Jalan Monkey Forest
Jl. Taman Giri - Banjar Mumbul, Nusa Dua => Jalan Taman Giri
Jalan Raya Manggis => Jalan Raya Manggis
Jalan Pantai Kuta => Jalan Pantai Kuta
Jalan Gajah Mada => Jalan Gajah Mada
Banjar Dinas Wangsean, Desa Wisma Kerta - Sidemen, Karangasem, Bali => Jalan Banjar Dinas Wangsean
Jl. Bisma => Jalan Bisma
Br. Tabola => Jalan Br. Tabola
Jalan Raya Amed Jemeluk Bunutan => Jalan Raya Amed Jemeluk Bunutan
Jalan Dhyana Pura => Jalan Dhyana Pura
Jalan Gunung Guntur => Jalan Gunung Guntur
Juannda Karta Wijaya => Jalan Uannda Karta Wijaya
Jalan Tanjung => Jalan Tanjung
Jalan Wenara Wana => Jalan Wenara Wana
jalan panestanan => Jalan Panestanan
Jl. Padma => Jalan Padma
Dsn Batu Dawa Kelod => Jalan Dsn Batu Dawa Kelod
Gang Sesapi => Jalan Gang Sesapi
Ciung Wanara 1 => Jalan Ciung Wanara 1
Kanda Street => Kanda Street
Jalan Gautama Selatan => Jalan Gautama Selatan
Jalan Panglima Besar Sudirman => Jalan Panglima Besar Sudirman
Jalan Perumahan Dalung Permai => Jalan Perumahan Dalung Permai
Jalan Bedugul Sidakarya, Denpasar - Bali => Jalan Bedugul Sidakarya
Laksamana 7 => Jalan Laksamana 7
Jalan Raya Pelabuhan, Pelabuhan Benoa => Jalan Raya Pelabuhan
Jalan Raya Legian => Jalan Raya Legian
Jalan Legian Kaja No. 458 => Jalan Legian Kaja No. 458
Petulu => Jalan Petulu
Jalan Melasti => Jalan Melasti
Tukad Unda 1 => Jalan Tukad Unda 1
Patih Jelantik => Jalan Patih Jelantik
Pudak => Jalan Pudak
Jalan Teuku Umar => Jalan Teuku Umar
Jalan Apuan-Senganan => Jalan Apuan
Jl. Pantai Seseh No 1 => Jalan Pantai Seseh No 1
Gang Kartika I => Jalan Gang Kartika I
Jalan Sandat => Jalan Sandat
Jalan Kamboja => Jalan Kamboja
Jalan Kayu Aya => Jalan Kayu Aya
Taman Mulia => Jalan Taman Mulia
Jalan Tukad Pakerisan => Jalan Tukad Pakerisan
Thamrin Gang 1 => Jalan Thamrin Gang 1
Jalan Nyuh Bojog => Jalan Nyuh Bojog
Jalan Pulau Nias => Jalan Pulau Nias
Jl. Dewi Sri Gang Salak 1 CU => Jalan Dewi Sri Gang Salak 1 CU
Jalan Munduk Catu 32 => Jalan Munduk Catu 32
Jalan Raya Buluh Indah => Jalan Raya Buluh Indah
Jalan Pasraman Unud => Jalan Pasraman Unud
jalan pura puseh tianyar barat => Jalan Pura Puseh Tianyar Barat
Danau Toba => Jalan Danau Toba
Jalan Petitenget => Jalan Petitenget
Jalan Legian Tengah => Jalan Legian Tengah
Jalan Surapati => Jalan Surapati
Jalan Kunti => Jalan Kunti
Br. Tebola => Jalan Br. Tebola
Pulau Nusakambangan => Jalan Pulau Nusakambangan
Jalan Pantai Indah => Jalan Pantai Indah
Raya Puputan => Jalan Raya Puputan
Dewi Sartika => Jalan Dewi Sartika
Jl. Goa Gong => Jalan Goa Gong
Jalan Raya Candi Kuning => Jalan Raya Candi Kuning
Jl. Surapati, Buleleng, Bali => Jalan Surapati
Jalan Raya Ubud => Jalan Raya Ubud
Jalan Werkudara => Jalan Werkudara
JLN. LANYAHAN, BR NAGI, => Jalan LANYAHAN
SMA 6 => Jalan SMA 6
Kaliasem => Jalan Kaliasem
Jalan Veteran => Jalan Veteran
Jl Tukad Badung => Jalan L Tukad Badung
Jl. Gajahmada Seririt => Jalan Gajahmada Seririt
Jalan Tukad Banyu Poh => Jalan Tukad Banyu Poh
Jalan Goutama => Jalan Goutama
Jalan Teuku Umar Barat => Jalan Teuku Umar Barat
Pierre Tendean => Jalan Pierre Tendean
Jl. Raya => Jalan Raya
Jalan Jaya Pangus => Jalan Jaya Pangus
Jalan Imam Bonjol => Jalan Imam Bonjol
Tukad Musi 1 => Jalan Tukad Musi 1
Jalan Jaya Tirtha => Jalan Jaya Tirtha
Terompong => Jalan Terompong
Jalan Kajeng => Jalan Kajeng
Jl. Sriwedari , => Jalan Sriwedari
